XXXXXSXXXXX
X   X X   X
X XXX XXX X
X         X
X XXX XXX X
X XKX X X X
X X X   X X
X X XXXXX X
X   X   D X
XXXXXEXXXXX