XXXXSXXX
E X    X
XDX XX X
X X  X X
X XX X X
X    XKX
XXXXXXXX
